{
    "name": "Level 1-1",
    "backgroundMusic": "Valse",
    "gravity": 40,
    "map": [
        [0,0,0,0,0,0,0,0,0,0,0,0,0,0,0,0,0,0,0,0,0,0,0,0,0,0,0,0,0,0,0,0,0,0,0,0,0,0,0,0,0,0,0,0,0,0,0,0,0,0,0,0,0,0,0,0,0,0,0,0,0,0,0,0,0,0,0,0,0,0,0,0,0,0,0,0,0,0,0,0,0,0,0,0,0,0,0,0,0,0,0,0,0,0,0,0,0,0,0,0,0,0,0,0,0,0,0,0,0,0,0,0,0,0,0,0,0,0,0,0,0,0,0,0,0,0,0,0,0,0,0,0,0,1,1,1,1,1,1,1,1,1,1,1,1,1,1,1,1,1,1,1,1,1,1,1,1,1,1,1,1,1,1,1,1,1,1,1,1,1,1,1,1,1,1,1,1,1,1,1,1,1,1,1,1,1,1,1,1,1,1,1,1,1,1,1,1,1,1,1,1,1,1,1,1,0,0,0,0,0,0,0,0,0,0,0,0,0,0,0,0,0,0,0,0],
        [0,0,0,0,0,0,0,0,0,0,0,0,0,0,0,0,0,0,0,0,0,0,0,0,0,0,0,0,0,0,0,0,0,0,0,0,0,0,0,0,0,0,0,0,0,0,0,0,0,0,0,0,0,0,0,0,0,0,0,0,0,0,0,0,0,0,0,0,0,0,0,0,0,0,0,0,0,0,0,0,0,0,0,0,0,0,0,0,0,0,0,0,0,0,0,0,0,0,0,0,0,0,0,0,0,0,0,0,0,0,0,0,0,0,0,0,0,0,0,0,0,0,0,0,0,0,0,0,0,0,0,0,0,0,0,0,0,0,0,0,0,0,0,0,0,0,0,2,2,2,2,2,2,2,2,2,2,0,0,0,0,0,0,0,0,0,0,0,0,0,0,0,0,0,0,0,0,0,0,0,0,0,0,0,0,0,0,0,0,0,0,0,0,0,0,0,0,0,0,0,0,0,0,0,0,0,0,0,0,1,1,1,1,1,1,1,0,0,0,0,0,0,0,0,0],
        [0,0,0,0,0,0,0,0,0,0,0,0,0,0,0,0,0,0,0,0,0,0,0,0,0,0,0,0,0,0,0,0,0,0,0,0,0,0,0,0,0,0,0,0,0,0,0,0,0,0,0,0,0,0,0,0,0,0,0,0,0,0,0,0,0,0,0,0,0,0,0,0,0,0,0,0,0,0,0,0,0,0,0,0,0,0,0,0,0,0,0,0,0,0,0,0,0,0,0,0,0,0,0,0,0,0,1,1,1,0,1,1,1,0,0,0,0,0,0,0,0,0,0,0,0,0,0,0,0,0,0,0,0,0,1,1,1,1,1,1,1,1,1,0,0,0,0,0,2,2,2,2,2,2,2,2,2,0,1,1,0,3,0,1,1,1,1,0,0,0,0,0,0,0,0,0,0,0,0,0,0,0,0,0,0,0,1,1,1,0,3,0,1,1,1,0,3,0,1,1,1,0,3,0,1,1,1,1,1,2,0,0,0,0,0,2,0,0,0,0,0,0,0,0,0],
        [0,0,0,0,0,0,0,0,0,0,0,0,0,0,0,0,0,0,0,0,0,0,0,0,0,0,0,0,0,0,0,0,0,0,0,0,0,0,0,0,0,0,0,0,0,0,0,1,0,0,0,0,0,0,0,0,0,0,0,0,0,0,0,0,0,0,0,0,0,0,0,0,0,0,0,0,0,0,0,0,0,0,0,0,0,0,0,0,0,0,0,0,0,0,0,0,0,0,0,0,0,0,0,0,0,1,2,0,0,0,0,0,2,1,0,0,0,0,0,0,0,0,0,0,0,0,0,0,0,0,0,0,0,0,0,2,2,2,2,2,2,2,2,0,0,0,0,0,2,2,2,2,2,2,2,2,0,0,2,2,1,1,1,2,0,0,2,1,0,3,1,0,3,0,1,0,3,0,1,3,0,1,0,1,1,1,2,0,2,1,1,1,2,0,2,1,1,1,2,0,2,1,1,1,2,2,0,0,0,0,0,1,0,0,0,2,0,0,0,0,0,0,0,0,0],
        [0,0,0,0,0,0,0,0,0,0,0,0,0,0,0,0,1,1,1,1,0,0,0,0,0,0,0,0,0,0,0,0,0,0,0,0,0,0,0,0,0,0,0,1,1,0,0,0,0,0,0,0,0,1,0,0,1,0,0,0,0,0,0,0,0,0,0,0,0,0,0,0,0,0,0,0,0,0,0,0,0,0,0,0,0,0,0,0,0,0,0,0,0,0,0,0,0,0,0,0,0,0,0,0,1,2,0,0,0,0,0,0,0,2,1,0,0,0,0,0,0,0,0,0,0,0,0,0,0,0,0,0,1,0,0,2,2,2,2,2,2,2,2,1,0,0,0,0,2,2,2,2,2,2,2,0,0,1,2,0,0,0,0,0,0,0,0,2,1,1,2,1,1,1,2,1,1,1,2,1,1,2,0,0,0,0,0,0,0,0,0,0,0,0,0,0,0,0,0,0,0,0,0,0,0,0,0,0,1,1,1,2,1,0,3,2,0,0,0,0,1,0,0,0,1],
        [0,0,0,0,0,0,0,0,0,0,0,0,0,0,0,0,0,0,0,0,0,0,0,0,0,0,0,0,0,0,0,0,0,0,0,0,0,0,0,0,0,0,0,0,0,0,0,0,0,0,0,0,1,2,0,0,2,1,0,0,0,0,0,0,0,0,0,0,0,0,0,1,0,0,0,0,0,0,0,0,0,0,0,0,0,0,0,0,0,0,0,0,0,0,0,0,0,0,0,0,0,0,0,1,2,0,0,0,0,0,0,0,0,0,2,1,0,0,0,0,0,0,0,0,0,0,0,0,0,1,0,0,0,0,0,2,2,2,2,2,2,2,2,2,0,0,0,0,0,2,2,2,2,2,0,0,0,2,2,0,0,5,0,0,0,0,0,0,0,0,0,0,0,0,0,0,0,0,0,0,0,2,1,1,1,1,1,1,1,1,1,1,1,1,1,1,1,1,1,1,1,1,1,1,1,1,1,1,2,2,2,2,2,1,1,2,1,1,1,1,2,0,0,0,2],
        [0,0,0,0,0,0,0,0,0,0,0,1,1,1,1,1,1,1,1,1,1,1,1,1,1,1,0,0,0,0,0,3,0,0,0,0,0,1,1,1,1,1,0,0,0,0,0,0,0,0,0,1,2,2,0,0,2,2,1,0,0,0,0,3,0,0,0,0,1,0,3,2,3,0,1,0,0,3,0,0,1,0,0,1,1,1,1,1,0,0,1,0,0,3,0,0,3,0,0,3,0,0,1,2,0,0,0,0,0,0,0,0,0,0,0,2,1,0,0,3,0,0,1,0,0,0,0,1,3,3,3,3,3,3,3,2,2,2,2,2,2,2,2,2,1,1,3,0,0,3,0,0,3,0,0,3,1,2,2,0,0,4,0,0,0,0,0,0,0,0,0,0,0,0,0,0,0,0,0,0,0,0,0,0,0,0,0,0,0,0,0,0,0,0,0,0,0,0,0,0,0,0,0,0,0,0,0,0,0,0,0,0,0,0,0,0,0,0,0,0,0,0,0,0,2],
        [1,1,1,1,1,1,1,1,1,1,1,2,2,2,2,2,2,2,2,2,2,2,2,2,2,2,1,1,1,1,1,1,1,1,1,1,1,2,2,2,2,2,1,1,1,1,1,1,1,1,1,2,2,2,0,0,2,2,2,1,1,1,1,1,1,1,1,1,2,1,1,2,1,1,2,1,1,1,1,1,2,0,0,2,2,2,2,2,0,0,2,1,1,1,1,1,1,1,1,1,1,1,2,0,0,0,0,0,0,0,0,0,0,0,0,0,2,1,1,1,1,1,2,0,0,0,0,2,1,1,1,1,1,1,1,2,2,2,2,2,2,2,2,2,2,2,1,1,1,1,1,1,1,1,1,1,2,2,2,1,1,1,1,1,1,1,1,1,0,0,1,1,1,0,1,1,1,0,1,1,1,1,1,1,1,1,1,1,1,1,1,1,1,1,1,1,1,1,1,1,1,1,1,1,1,1,1,1,1,1,1,1,1,1,1,1,1,1,1,1,1,1,1,1,2]
    ],
    "specialTiles": [
        {
            "class": "GoalTile",
            "x": 161,
            "y": 6
        }
    ],
    "playerData": {
        "x": 2,
        "y": 1,
        "initialDirection": "RIGHT"
    },
    "enemies": [
        {
            "class": "RebounderEnemy",
            "x": 31,
            "y": 6
        },
        {
            "class": "RebounderEnemy",
            "x": 63,
            "y": 6
        },
        {
            "class": "RebounderEnemy",
            "x": 70,
            "y": 6
        },
        {
            "class": "RebounderEnemy",
            "x": 72,
            "y": 6
        },
        {
            "class": "RebounderEnemy",
            "x": 77,
            "y": 6
        },
        {
            "class": "RebounderEnemy",
            "x": 93,
            "y": 6
        },
        {
            "class": "RebounderEnemy",
            "x": 96,
            "y": 6
        },
        {
            "class": "RebounderEnemy",
            "x": 99,
            "y": 6
        },
        {
            "class": "RebounderEnemy",
            "x": 119,
            "y": 6
        },
        {
            "class": "RebounderEnemy",
            "x": 128,
            "y": 6
        },
        {
            "class": "RebounderEnemy",
            "x": 129,
            "y": 6
        },
        {
            "class": "RebounderEnemy",
            "x": 130,
            "y": 6
        },
        {
            "class": "RebounderEnemy",
            "x": 131,
            "y": 6
        },
        {
            "class": "RebounderEnemy",
            "x": 132,
            "y": 6
        },
        {
            "class": "RebounderEnemy",
            "x": 133,
            "y": 6
        },
        {
            "class": "RebounderEnemy",
            "x": 134,
            "y": 6
        },
        {
            "class": "RebounderEnemy",
            "x": 146,
            "y": 6
        },
        {
            "class": "RebounderEnemy",
            "x": 149,
            "y": 6
        },
        {
            "class": "RebounderEnemy",
            "x": 152,
            "y": 6
        },
        {
            "class": "RebounderEnemy",
            "x": 155,
            "y": 6
        },
        {
            "class": "RebounderEnemy",
            "x": 161,
            "y": 2
        },
        {
            "class": "RebounderEnemy",
            "x": 169,
            "y": 3
        },
        {
            "class": "RebounderEnemy",
            "x": 172,
            "y": 3
        },
        {
            "class": "RebounderEnemy",
            "x": 176,
            "y": 3
        },
        {
            "class": "RebounderEnemy",
            "x": 179,
            "y": 3
        },
        {
            "class": "RebounderEnemy",
            "x": 190,
            "y": 2
        },
        {
            "class": "RebounderEnemy",
            "x": 196,
            "y": 2
        },
        {
            "class": "RebounderEnemy",
            "x": 202,
            "y": 2
        },
        {
            "class": "RebounderEnemy",
            "x": 214,
            "y": 4
        }
    ]
}
